15
MMMMMMMMMMMMMMM
MVVVVVVVVVVVVVM
MVVVVVVVVVVVVVM
MVVVVVVVVVVVVVM
MVVVVVVVVVVVVVM
MVVVVVVVVVVVVVM
MVVVVVVVVVVVBVM
MVVVVVVVVVVVVVM
MVVVVVVVVVVVVVM
MVAVVVVVVVVVVVM
MVVVVVVVVVVVVVM
MVVVVVVVVVVVVVM
MVVVVVVHVVVVVVM
MMMMMMMMMMMMMMM