20
MMMMMMMMMMMMMMMMMMMM
MVVVVVVVVVVVVVVVVVVM
MVVVVVVVVVVVVVVVVVVM
MVVVVVVVVVVVVVVVVVVM
MVVVVVVVVVVVVVVVVVVM
MVVVVVVVVVVVVVVVVVVM
MVVAVVVVVVVVVVVVVVVM
MVVVVVVVVVVVVVVVVVVM
MVVVVVVVVVVVVVVVVVVM
MVVVVVVVVVVVVVVVVVVM
MVVVVVVVVVVVVVVVVVVM
MVVVVVVVVVVVVVVVVVVM
MVVVVVVVVVVVVVVBVVVM
MVVVVVVVVVVVVVVVVVVM
MVVVVVVVVVVVVVVVVVVM
MVVVVVVHVVVVVVVVVVVM
MVVVVVVVVVVVVVVVVVVM
MVVVVVVVVVVVVVVVVVVM
MVVVVVVVVVVVVVVVVVVM
MVVVVVVVVVVVVVVVVVVM
MMMMMMMMMMMMMMMMMMMM