8
8
MMMMMMMM
MGGGGGMM
MGVVVBGM
MGVVVVGM
MGVVVVGM
MGVVHAGM
MGGGGGGM
MMMMMMMM