10
10
MMMMMMMMMM
MGGGGGGGMM
MGHVVVVBGM
MGVVVVVAGM
MGVVVVVVGM
MGVVVVVVGM
MGVVVVVVGM
MGVVVVVVGM
MGGGGGGGGM
MMMMMMMMMM