8
8
MMMMMMMM
MMMMMMMM
MVMVMVMM
MCVCVCVM
MHCVCVBM
MMVMVMAM
MMMMMMMM
MMMMMMMM
