10
10
MMMMMMMMMM
MVVVVVVVVM
MVVVVVVVVM
MVVAVVVVVM
MVVVHVVVVM
MVVVVVVCVM
MVVVVVBVVM
MVVVVVVCVM
MVVVVVCVVM
MMMMMMMMMM