10
10
MMMMMMMMMM
MVVVVVVVVM
MVVVVVVVVM
MVVAVVVVVM
MVVVHVVVVM
MVVVVVVVVM
MVVVVVBVVM
MVVVVVVVVM
MVVVVVVVVM
MMMMMMMMMM