10
10
MMMMMMMMMM
MVVVVVVVVM
MVFFTVVFVM
MTVAVTVVVM
MVVVHVVVVM
MVVFFFVVVM
MVVVVVBVVM
MVVTVVVVVM
MVVFVVVVVM
MMMMMMMMMM