10
10
MMMMMMMMMM
MVVVVVVVVM
MVVVVVVFVM
MVVAVTVVVM
MVVVHVVVVM
MVVFFFVCVM
MVVVVVBVVM
MVVVVVVCVM
MVVVVVCVVM
MMMMMMMMMM