8
8
MMMMMMMM
MMMMMMMM
MMMMMMMM
MMAGVVVM
MHBGVVVM
MMMMVVMM
MMMMMMMM
MMMMMMMM
        