15
15
MMMMMMMMMMMMMMM
MVVVVVVVVVVVVVM
MVVVVVBVVVVVVVM
MMMMMMMMVVVVVVM
MMMMMMMMVVVVVVM
MMMMMMMMVVVVVVM
MVVVVVVVVVVVVVM
MVVVVVVHVVVVVVM
MVVVVVVVVVVVVVM
MVVVVVVVVVVVVVM
MVVVVVVVVVVVVVM
MVVVVVVVVVVVVVM
MVMVVVVVVVVVVVM
MAMVVVVVVVVVVVM
MMMMMMMMMMMMMMM